語言	代碼
阿拉伯文	ar-XA
保加利亞文	bg
克羅埃西亞文	hr
捷克文	cs
丹麥文	da
德文	de
希臘文	el
英文	en
愛沙尼亞文	et
西班牙文	es
芬蘭文	fi
法文	fr
愛爾蘭文	ga
印度文	hi
匈牙利文	hu
希伯來文	he
義大利文	it
日文	ja
韓文	ko
拉脫維亞文	lv
立陶宛文	lt
荷蘭文	nl
挪威文	no
波蘭文	pl
葡萄牙文	pt
瑞典文	sv
羅馬尼亞文	ro
俄文	ru
塞爾維亞文	sr-CS
斯洛伐克文	sk
斯洛維尼亞文	sl
泰文	th
土耳其文	tr
烏克蘭文	uk-UA
簡體中文	zh-chs
繁體中文	zh-cht
